#####################
S #     #         # #
#        # #        #
# #   # #     #     #
#  #     #       #  #
# #  #          #   #
#              # #  #
#                   #
#  # #           #  #
#     #   #         #
#        #     #    #
#     # #   #   #   #
#          #       ##
#     #   #  #    # #
#        #       #  #
# #         #T      #
##   # #            #
#     # # #         #
##       #         ##
#               #   #
#####################