#############
S #         #
#           #
#           #
#  #   #    #
#   #   #   #
#    # #    #
#     # #   #
#  #     #  #
#   #   #   #
#  # # #    #
#           #
#############
