#############
#           #
#      #    #
#         # S
#  # #      #
#           #
#           #
#     #   # #
#  # #      #
#     #     #
#           #
#           #
#############
