%%%%%%%%%%%S%
% %         %
%           %
%           %
%           %
% %         %
%%         %%
%           %
%           %
%           %
%           %
%           %
%%%%%%%%%%%%%
