%%%%%%%%%%%%%
%           %
%  %        %
%       %   %
%  %       %%
%   %   %   %
%      %    %
%         % %
%           %
%           %
%           %
%           S
%%%%%%%%%%%%%
