%%%%%%%%%%%%%
S %         %
%           %
%           %
%  %   %    %
%   %   %   %
%    % %    %
%     % %   %
%  %     %  %
%   %   %   %
%  % % %    %
%           %
%%%%%%%%%%%%%
