#############
#           S
#  #        #
#       #   #
#  #       ##
#   #   #   #
#      #    #
#         # #
#           #
#           #
#           #
#           #
#############
