#############
#     #   # #
#  # #      #
S           #
##       #  #
#   # #     #
#  #       ##
# #     #   #
#        #  #
#     #     #
#           #
# # #   #   #
#############