#########S###
#           #
#           #
#   #       #
#  #   # #  #
#           #
#      #    #
#   #       #
#      #    #
#   #       #
#           #
#           #
#############