#############
#           #
#  #        #
#       #   #
#  #       ##
#   #   #   #
#      #    #
#         # #
#           #
#           #
#           #
#           S
#############
