#############
#   #       #
#  # #   #  #
#   #   #   #
#    #   #  #
# #         #
#  #        #
#     # #   S
#  # # # #  #
#           #
#        #  #
#       #   #
#############
