#############
#           #
#    #      #
#     #     #
#        #  #
# #     #   #
#           #
#           #
#  #       ##
#   #     # #
#           #
#           #
#######S#####
