###########S#
# #         #
#           #
#           #
#           #
# #         #
##         ##
#           #
#           #
#           #
#           #
#           #
#############
