#################
#               #
#      #        #
#   #     # #   #
##              #
#     # # #     #
#  #            #
# #             #
#        # #    S
#   # #   #     #
#    #   #   #  #
#         #   # #
#  #   #   #    #
#     #   #T    #
#  #           ##
#     # #   #   #
#################