#################
#               #
#      #        #
#   #     # #   #
##              #
#     # # #     #
#  #            #
# #             #
#        # #    #
#   # #         #
#    #   #   #  #
#         #   # #
#  #   #   #    #
#     #   #T    #
#  #           ##
#     # #   #   #
###########S#####