#################
S     # #   #   #
#    #   #      #
#   #   #   #   #
#        #      #
#   #       #   #
#      #   #   ##
#               #
##         #   ##
#       #   #   #
#          #   ##
#   #   # #     #
#    #   # #    #
# #       #  T  #
##       #      #
#     #         #
#################